################# #################
# .............#...#..............#
#.######.#####.#.#.#.#####.######.#
#.#    #.#   #.#.#.#.#   #.#    #.#
#.######.#####.#.#.#.#####.######.#
#.................................#
#.######.#.######.######.#.######.#
#......#.#.....#...#.....#.#......#
#.##.#.#.#####.#.#.#.#####.#.#.##.#
#.##.#.#.#.....#.#.#.....#.#.#.##.#
#....#.#.#.#.#.......#.#.#.#.#....#
####.......#.#.## ##.#.#.......####
 ....#####.#...#   #...#.#####.... 
####.......#.#.#####.#.#.......####
#....#.#.#.#.#.......#.#.#.#.#....#
#.##.#.#.#.....#.#.#.....#.#.#.##.#
#.##.#.#.#####.#.#.#.#####.#.#.##.#
#......#.#.....#...#.....#.#......#
#.######.#.######.######.#.######.#
#.................................#
#.######.#####.#.#.#.#####.######.#
#.#    #.#   #.#.#.#.#   #.#    #.#
#.######.#####.#.#.#.#####.######.#
#..............#...#..............#
################# #################
