# # # # # # # # # # # # # # # # # #
 ................................. 
#.#.#.#.#.#.#.#.#.#.#.#.#.#.#.#.#.#
 ................................. 
#.#.#.#.#.#.#.#.#.#.#.#.#.#.#.#.#.#
 ................................. 
#.#.#.#.#.#.#.#.#.#.#.#.#.#.#.#.#.#
 ................................. 
#.#.#.#.#.#.#.#.#.#.#.#.#.#.#.#.#.#
 ................................. 
#.#.#.#.#.#.#.#.#.#.#.#.#.#.#.#.#.#
 ................................. 
#.#.#.#.#.#.#.#.#.#.#.#.#.#.#.#.#.#
 ................................. 
#.#.#.#.#.#.#.#.#.#.#.#.#.#.#.#.#.#
 ................................. 
#.#.#.#.#.#.#.#.#.#.#.#.#.#.#.#.#.#
 ................................. 
#.#.#.#.#.#.#.#.#.#.#.#.#.#.#.#.#.#
 ................................. 
#.#.#.#.#.#.#.#.#.#.#.#.#.#.#.#.#.#
 ................................. 
#.#.#.#.#.#.#.#.#.#.#.#.#.#.#.#.#.#
 ................................. 
# # # # # # # # # # # # # # # # # #
