###################################
# ................................#
#################################.#
#...#...#...#...#...#...#...#...#.#
#.#.#.#.#.#.#.#.#.#.#.#.#.#.#.#.#.#
#.#.#.#.#.#.#.#.#.#.#.#.#.#.#.#.#.#
#.#.#.#.#.#.#.#.#.#.#.#.#.#.#.#.#.#
#.#.#.#.#.#.#.#.#.#.#.#.#.#.#.#.#.#
#.#.#.#.#.#.#.#.#.#.#.#.#.#.#.#.#.#
#.#.#.#.#.....#.#.........#.#.#.#.#
#...#.#.#.#.#.....###.###.#.#.....#
###............## ###.##.......####
#....#####.#...#   #.....#####....#
####.......#.#.#####.#.#.......####
#....#.#.#.#.#.......#.#.#.#.#....#
#.##.#.#.#.....#.#.#.....#.#.#.##.#
#.##.#.#.#####.#.#.#.#####.#.#.##.#
#......#.#.....#...#.....#.#......#
#.######.#.######.######.#.######.#
#.................................#
#.######.#####.#.#.#.#####.######.#
#.#    #.#   #.#.#.#.#   #.#    #.#
#.######.#####.#.#.#.#####.######.#
#..............#...#..............#
###################################
