####.####
#.......#
#.##.##.#
..#...#..
#.##.##.#
#.......#
####.####
